################################################################################
################################################################################
#########                         ##############################################
######### ####################### ##############################################
######### ####################### ##############################################
######### ####################### ##############################################
######### ####################### ##############################################
######### ####################### ##############################################
#########                ######## #####################################         
######################## ######## ##################################### ########
######################## ######## ############                          ########
######################## ######## ############ #################################
######################## ######## ############ #################################
######################## ######## ############ #################################
######################## ######## ############ #################################
                         ######## ############ #################################
################################# ############ #################################
################################# ############          ########################
########################          ##################### ########################
######################## ############################## ########################
######################## ############################## ########################
######################## ############################## ########################
######################## ############################## ########################
######################## ############################## ########################
######################## ############################## ########################
########################                                ########################
################################################################################
################################################################################
################################################################################
################################################################################