################################################################################
################################################################################
################################################################################
################################################################################
################################################################################
################################################################################
#########                       ##############                        ##########
######### ##################### ############## ###################### ##########
######### ##################### ############## ###################### ##########
######### ##################### ############## ###################### ##########
######### ##################### ############## ###################### ##########
#########       ############### ############## #################      ##########
############### ############### ############## ################# ###############
############### ############### ############## ################# ###############
############### ############### ############## ################# ###############
                 *#############        #       #################                
############### ############### ############## ################# ###############
############### ############### ############## ################# ###############
############### ############### ############## ################# ###############
#########       ############### ############## #################      ##########
######### ##################### ############## ###################### ##########
######### ##################### ############## ###################### ##########
######### ##################### ############## ###################### ##########
######### ##################### ############## ###################### ##########
#########                       ##############                        ##########
################################################################################
################################################################################
################################################################################
################################################################################
################################################################################