######################################################################### #### #
######################################################################### #### #
#########################################################################      #
#############################################                        ###########
#                                             ###################### ##### ###@#
# ## ## ## ##### ## ## ## #####^##^################################# ##### ### #
# ## ## ## ##### ##^## ##^##### #######################                    ### #
# ## ## ##^##### ## ##^## ############################# ###################### #
# ## ## ## #####^## ## #######          ############### ###################### #
# ## ## ## ##### ## ########## ######## ###############                        #
# ## ## ## ##### ############# ######## ########################################
# ## ## ## ################### ######## ########################################
# ## ##*###################### ######## ########################################
# ## ######################### ######## ########################################
#                              ########  #######################################
#######################################  ########                              #
######################################## ######## ######################### ## #
######################################## ######## ###################### ## ## #
######################################## ######## ################### ## ## ## #
######################################## ######## ############# ##### ## ## ## #
#                         ############## ######## ########## ## #####^## ## ## #
# ####################### ##############          ####### ## ## ##### ## ## ## #
# ####################### ############################ ## ##^## ##### ##^## ## #
# ###                     ###################### ##### ##^## ##^##### ## ## ## #
# ### ##### #################################^##^#####^## ## ## ##### ## ## ## #
# ### ##### #######################                                            #
# #########                         ############################################
# ##############################################################################
# ##############################################################################
# ##############################################################################