######################################################################### #### #
######################################################################### #### #
#########################################################################      #
#############################################                        ###########
#                                             ###################### ##### ###@#
# ## ## ## ##### ## ## ## ##### ## ################################# ##### ### #
# ## ## ## ##### ## ## ## ##### #######################                    ### #
# ## ## ## ##### ## ## ## ############################# ###################### #
# ## ## ## ##### ## ## #######          ############### ###################### #
# ## ## ## ##### ## ########## ######## ###############                        #
# ## ## ## ##### ############# ######## ########################################
# ## ## ## ################### ######## ########################################
# ## ##*###################### ######## ########################################
# ## ######################### ######## ########################################
#                              ########  #######################################
#######################################  ########                              #
######################################## ######## ######################### ## #
######################################## ######## ###################### ## ## #
######################################## ######## ################### ## ## ## #
######################################## ######## ############# ##### ## ## ## #
#                         ############## ######## ########## ## ##### ## ## ## #
# ####################### ##############          ####### ## ## ##### ## ## ## #
# ####################### ############################ ## ## ## ##### ## ## ## #
# ###                     ###################### ##### ## ## ## ##### ## ## ## #
# ### ##### ################################# ## ##### ## ## ## ##### ## ## ## #
# ### ##### #######################                                            #
# #########                         ############################################
# ##############################################################################
# ##############################################################################
# ##############################################################################