################################################################################
######                                                                         #
# #### ###################################### ############################## # #
# #### ########                       #######                    ########### # #
#      ######## ##################### ########################## ########### # #
# ############# ##                  # ###                     ## ########### # #
# ############# ## ################ # ### ################### ## ########### # #
# ############# ## #*               # ### #* ################ ## ########### # #
# ############# ## ################## ### ##                  ## # ######### # #
# ############# ##                    ### ###################### # ######### # #
# ############# #########################                        # ######### # #
# ############# #           ############################### ###### ######### ###
# ############# # ######### ##                       ###### ###### ######### ###
# ############# # #       # ## ##################### ###### ###### #############
# ############# # #*##### # ## #                            ######## ######### #
# ############# # ####### # ## # ################# # ############# ######### # #
# ############# #         # ## #                *# # ############# ######### # #
# ############# ########### ## ################### # ############# ######### # #
#             #             ##                     # ############# ######### # #
# # ######### # #################################### ############# ######### # #
# #         #                                        ############# ######### # #
# ######### # ########### ######################################## ######### # #
# #       # #        #### #############  ######################### #       # # #
# # ##### # ######## #### ###########   ########################## ######### # #
# # #     #       ## #### ##   #####  #####                        #         # #
# # # ##### ##### ## #### #### ###    ####  ## ################### # ######### #
# # # #   # #     ## #### ####     ###     ### #                   # #       # #
# ### # # # # ###### #### ######## ##  ####### # ################### #######   #
# ###   #   #        ####             ######## #                             ###
# ##############################################################################