################################################################################
#             #   #   #   #   #   #   #   #   #   #   #   #   #   #   #   ######
# ########### # # # # # # # # # # # # # # # # # # # # # # # # # # # # # # #   ##
#           # # # # # # # # # # # # # # # # # # # # # # # # # # # # # # # # # ##
########### # # # # # # # # # # # # # # # # # # # # # # # # # # # # # # # # # ##
#           #   #   #   #   #   #   #   #   #   #   #   #   #   #   #   #   # ##
# ########################################################################### ##
#           #                  #               #                              ##
########### # ################ # ############# # ###############################
#           # #   #   #   #### # #           # # #                             #
# ########### # # # # # # #### # # ######### # # # ########################### #
#           # # # # # # # #### # # #       # # # # ##                     #### #
########### # # # # # # # #### # # # ##### # # # # ## ################### #### #
#           # # # # # # # #### # # # ##  # # # # # ## #                 # #### #
# ########### # # # # # # #### # # #     # # # # # ## # ############### # #### #
#           # # # # # # # #### # # ####### # # # # ##   #               # #### #
########### # # # # # # # #### # #         # # # # ###### ############### #### #
#           # # # # # # # #### # ########### # # #        ############### #### #
# ########### # # # # # # #### #             # # ######################## #### #
#           # # # # # # # #### ############### # ######################## #### #
########### #   #   #   #   ##                 #                          #### #
#           ############### ################################################## #
# ################## ##   #                                                    #
#                    ## # # # ##################################################
####################    # # # ##################################################
#   #   #   #   ##### ### # #                                                  #
# #   #   #   #             ################################################## #
# ############################################################################ #
#                           #*                                                 #
################################################################################