################################################################################
#                           ########### ####         ###     #              ####
# ######################### ########### ############ ### ### # #################
# ##            ##          ###########                  ### # ######        ###
# ## #### ##### ## ######################################### #        ###### ###
# ## #### ##### ##          ###########                      ############### ###
# ## #### ################# ##        # #### ##################          ### ###
# ## #### #                 ## ######## #### #######         ## ######## ### ###
# ####### # ############### ## ######## #### ####### ########## ### ####     ###
          # ######       ## ##     ^    ####             ###### ###^############
########### ###### ######## ######### ################### #####           ### ##
#           ###### ######   #########   ############# ### ########## ######## ##
# ################ ###### #############         ####      ##  ###### ######## ##
# #         ######        #####       ^######## #### ####### #######          ##
# # ####### ###### ###################        # #### #######         ######## ##
# # ###^### ###### #######         ### ###### # ###   ################ ###### ##
# #     ###      #      ## ####### ### ###### #  ## # #####          #^###### ##
# ######### #### # ####### ####### ### ###### ##    # ###^ #########          ##
#           ##   #      ##    ####     ###### #######     ##########  ##########
################## #### ##### ##### #########         ############## ###########
##                 ####           # ################################         ###
##  ############################### ##   ########       #################### ###
#  ##     ##        ############### #### ###   # ######                       ##
# ### ### ## ###### ###### ########       ^# ### ###### ##################### ##
# ### ### ##  ##### ###### ######## ### #### ### ###### ############          ##
# ### ### ### #####*###### ######## ### ###         ###           ## ###########
# ### ###     ############ ######## ### ########### ####### ##### ##############
#     ##########                    ###             ####### ####################
#####          ####################################                     ########
################################################################################
