################################################################################
###########################################             ########################
###########################################  ########## ########################
#########################################   ########### #####        ###########
####                 #####                        ##### ###    #################
#### ### ### ### ### ##### ####### #   #   #   # ######                  *######
#### ### ### ### ### ##### ###### #   #   #   # # #########    #################
#### ### ### ### ### ##### ##### #   #   #   # # ############        ###########
S                          #### # #   #   #   # # ##############################
## ### ### ### ### ############# # #   #   #   # ###############################
## ### ### ### ### ################ #   #   #   # ##############################
## ### ### ### ### ################# #   #  #  # ###############################
##                 ####################  # #  ################### ##############
#######################################  ##  #################### ##############
###          #########                           ############         ##########
### ### ############   ##### #### ##########   ############## ##################
/   ### ############ # ########## ###########                    ###############
### ################ #          # ############## ############### ###############
###       ########## ############ ########### ## ############### ###############
### ##### ####                ############### ## ######## ###### ###############
###   ### ################### ############### ## ######## ######  ##############
######### ###           #####      ###           ######## #######     ##########
######### ### ######### ##### ######## #########  ####### ####### ##############
#         ### #########       ####     ########## ####### ####### ##############
# ########### #################### ## ########### #######             ##########
# #        ## #################### ##          ## ####### ######################
# # #########             ########### #########           ######################
#             ###########             ################### ######################
################################################################################
################################################################################