################################################################################
################################################################################
###################### ##################       ####                         ###
########         ##### ################## ##### #### ####################### ###
####     ####### ##    ###############    #####           ########         # ###
######## #######    ################## ########################### #########*###
######## ########## ###########                     ############## #############
##################  #################   ##########################             /
####                          ######### ########################## #############
#### ####### ########  ###### ######### ####################       #############
#### ####### #### #### ###### ######### #             ######  ##################
#### ############ #### ###### ##        # ########### ######  ##################
#### ############ ####### ### ## ###### # #         # ######  ###  #############
#### ############ ####### ### ## ###### # ######### # #          ###############
#### ###          ####### ### ######### #           # ########## ###############
################# #######               ############# ##########      ##########
################# ####### #############                 #############  #########
####   ##### #### ####### ############# ############# ################  ########
#### ####### #### ####### ######### ### ############# #################  #######
#### #######              ######### ###     ######### ##################  ######
#### ####### ############ #######       #############                ####     ##
####         ########     ####### # ################################ ######## ##
############ ############ ####### ##############        ############ ######## ##
#####     ## ############ ####### ############## #######              ####### ##
##### ###### ####  ###### ####### ############## ####################         ##
##### ###### #### #######                            ###########################
S     ###### ####     ### ##### ############## #####        ####################
##### ###### #### ####### ##### ############## ############   ##################
#####                     #####    ########### #############            ########
################################################################################