################################################################################
#            #######                  #######                 ##########       #
# ####  ####  #####  ####  #####  ###  #####  ###  #####  ###  ######### #######
# ###  ######  ###  ######  ###  #####  ###  #####  ###  #####  ######## #######
# ##  ########  #  ########  #  #######  #  #######  #  #######  ####### #######
# ###  ######  ###  ######  ###  #####  ###  #####  ###  #####  ######## #######
# ####  ####  #####  ####  #####  ###  #####  ###  #####  ###  ######### #######
# #####      #######      #######  #  #######  #  #######  #  ########## #######
# ####  ####  #####  ####  #####  ###  #####  ###  #####  ###  ######### #######
# ###  ######  ###  ######  ###  #####  ###  #####  ###  #####  ######## #######
# ##  ########  #  ########  #  #######  #  #######  #  #######  ####### #######
# ###  ######  ###  ######  ###  #####  ###  #####  ###  #####  ######## #######
# ####  ####  #####  ####  #####  ###  #####  ###  #####  ###  ######### #######
# #####      #######      #######  #  #######  #  #######  #  ########## #######
# ####  ####  #####  ####  #####  ###  #####  ###  #####  ###  ######### #######
# ###  ######  ###  ######  ###  #####  ###  #####  ###  #####  ######## #######
# ##  ########  #  ########  #  #######  #  #######  #  #######  ####### #######
# ###  ######  ###  ######  ###  #####  ###  #####  ###  #####  ######## #######
# ####  ####  #####  ####  #####  ###  #####  ###  #####  ###  ######### #######
# #####      #######      #######  #  #######  #  #######  #  ########## #######
# ####  ####  #####  ####  #####  ###  #####  ###  #####  ###  ######### #######
# ###  ######  ###  ######  ###  #####  ###  #####  ###  #####  ######## #######
# ##  ########  #  ########  #  #######  #  #######  #  #######  ####### #######
# ###  ######  ###  ######  ###  #####  ###  #####  ###  #####  ######## #######
# ####  ####  #####  ####  #####  ###  #####  ###  #####  ###  ######### #######
# #####      #######  ##  #######  #  #######  #  #######  #  ########## #######
# #######  ##########    #########   #########   #########   ########### #######
# #######  ###########  ########### ########### ########### ############ #######
# #######               ###########             ###########      *       #######
# ##############################################################################