################################################################################
#            #######                  #######                 ########         #
# ####  ####  #####  ####  #####  ###  #####  ###  #####  ###  ######  ###  ####
# ###  ######  ###  ######  ###  #####  ###  #####  ###  #####  ####  #####  ###
# ##  ########  #  ########  #  #######  #  #######  #  #######  ####  ###  ####
# ###  ######  ###  ######  ###  #####  ###  #####  ###  #####  ######  #  #####
# ####  ####  #####  ####  #####  ###  #####  ###  #####  ###  ######  ###  ####
# #####      #######      #######  #  #######  #  #######  #  ######  #####  ###
# ####  ####  #####  ####  #####  ###  #####  ###  #####  ###  ######  ###  ####
# ###  ######  ###  ######  ###  #####  ###  #####  ###  #####  ######  #  #####
# ##  ########  #  ########  #  #######  #  #######  #  #######  ####  ###  ####
# ###  ######  ###  ######  ###  #####  ###  #####  ###  #####  ####  #####  ###
# ####  ####  #####  ####  #####  ###  #####  ###  #####  ###  ######  ###  ####
# #####      #######      #######  #  #######  #  #######  #  ########  #  #####
# ####  ####  #####  ####  #####  ###  #####  ###  #####  ###  ######  ###  ####
# ###  ######  ###  ######  ###  #####  ###  #####  ###  #####  ####  #####  ###
# ##  ########  #  ########  #  #######  #  #######  #  #######  ####  ###  ####
# ###  ######  ###  ######  ###  #####  ###  #####  ###  #####  ######  #  #####
# ####  ####  #####  ####  #####  ###  #####  ###  #####  ###  ######  ###  ####
# #####      #######      #######  #  #######  #  #######  #  ######  #####  ###
# ####  ####  #####  ####  #####  ###  #####  ###  #####  ###  ######  ###  ####
# ###  ######  ###  ######  ###  #####  ###  #####  ###  #####  ######  #  #####
# ##  ########  #  ########  #  #######  #  #######  #  #######  ####  ###  ####
# ###  ######  ###  ######  ###  #####  ###  #####  ###  #####  ####  #####  ###
# ####  ####  #####  ####  #####  ###  #####  ###  #####  ###  ######  ###  ####
# #####      #######  ##  #######  #  #######  #  #######  #  ########  #  #####
# #######  ##########    #########   #########   #########   ##########   ######
# #######  ###########  ########### ########### ########### ############ #######
# #######               ###########             ###########      *       #######
# ##############################################################################