################################################################################
################################################################################
######################        ###########       ####                         ###
########         ##### ###### ########### ##### #### ####################### ###
####*  $ ####### ##    ###### ########    #####           ########   $     # ###
######## #######    ######### ######## ########################### #########*###
######## ########## ######### #                          ######### #############
######## ########## ######### ######### ##########################    @        #
####                          ######### ########################## #############
#### ################# ###### ######### ####################       #############
#### ############ #### ###### ######### #             ######  ##################
#### ############ #### ###### ##        # ########### ######  ##################
#### ############ ####    ### ## ###### # #         # ######  ##################
#### ############ ####### ### ## ###### # ######### # ##         ###############
####              ####### ### ## ###### #           # ########## ###############
################# #######               ############# ##########      ##########
################# ####### #############               ############### ##########
####   ##### #### ####### ############# ############# ############### ##########
#### ####### #### ####### #########     ############# ############### ##########
#### #######              ######### ### ############# ############### ##########
#### ####### ############ #######       #############               #         ##
####         ########     ####### ########################################### ##
############ ############ ####### ##############        ########### ######### ##
#####     ## ############ ####### ############## #######            ######### ##
##### ###### ####  ###### ####### ############## ##################           ##
##### ###### #### #######                            ###########################
      ###### ####     ### ##### ############## #####        ####################
##### ###### #### ####### ##### ############## ############   ##################
#####                     #####    ########### #############            ########
################################################################################