################################################################################
################################################################################
################################################################################
################################################################################
###############################                        #########################
############################### ###################### #########################
############################### #         ##         # #########################
############################### #         ##         # #########################
############################### #         ##         # #########################
############################### ###################### #########################
############################### #         ##         # #########################
############################### #         ##         # #########################
############################### #         ##         # #########################
############################### ###################### #########################
###############################                        #########################
################################################################################
################################################################################
################################################################################
# ##############################################################################
# ##############################################################################
# ##############################################################################
# ##############################################################################
# ##############################################################################
# ###############                       ########################################
#                                             ##################################
#                                             ##################################
# ###############                       ##### ##################################
# ###############                       ##### ##################################
# ###############                       ##### ##################################
# ########################################### ##################################