################################################################################
################################################################################
################################################################################
################################################################################
################################################################################
################################################################################
#######################         #######             #########         ##########
########         ###### ####### ####### ########### ######### ####### ##########
######## ####### ###### #######                 ### ######### #######    #######
########       # ######      ################## ###      #### ########## #######
################ ###### #### ################## ######## #### ########## #######
############     ###### #### ############      ### #####         ####### #######
############ ########## #### ############ ######### #### ####### ####### #######
############            ####           ############ #### ####### ####### #######
############ ######################### #          # ####       # ###############
#####               ################## # ### #### # ############ ######    #####
############ ###### #                  # ### #### #      ####### ###### ########
############ #      # ################## ### #### # ####   #####        ########
############ ######## ################## ### #### # #   ##   ###################
############          ##                 ### #### # # #  ###    ################
##################### ## ############ ###### #### # # ##  #####         ########
##################### ## ############ ###### ####   # ###     # ####### ########
#####################         #######    ### ###### # ######### ####### ########
######################## ###############            #           ####### ########
#################################################################       ########
################################################################################
################################################################################
################################################################################
################################################################################
################################################################################
